NO ./images_png/1.png
SO ./images_png/2.png
WE ./images_png/3.png
EA ./images_png/4.png

F 220,100,0
C 225,30,0

1111111111111111111111111111111111111111
1000000000000000000000000000000000000001
1000000000000000000000000000000000000001
1000000000000000001111100000000000000001
1000000000000000001000100000000000000001
1000000000000000001000100000000000000001
1000000000000000001000100000000000000001
1000000001111111111000111111111100000001
1000000001000000000000000000000100000001
1000000001000000000000000000000100000001
1000000001111111111000111111111100000001
1000000000000000001000100000000000000001
1000000000000000001000100000000000000001
1000000000000000001000100000000000000001
1E00000000000000001111100000000000000001
1000000000000000000000000000000000000001
1000000000000000000000000000000000000001
1000000000000000000000000000000000000001
1000000000000000000000000000000000000001
1111111111111111111111111111111111111111