NO ./path_to_the_north_texture
SO ./path_to_the_south_texture
WE ./path_to_the_west_texture
EA ./path_to_the_east_texture

F 220,100,0
C 225,30,0

1111111111111111111111111
1N00100010000010000000001
1011101110111011111101101
1000100010100010001000101
1110111010101110101111101
1000101010001010101000001
1011101011111011101011101
1000001000100010100010101
1111111111111111111111111