NO ./path_to_the_north_texture
SO ./path_to_the_south_texture
WE ./path_to_the_west_texture
EA ./path_to_the_east_texture

F 220,155,200
C 225,230,0

        1111111111111111111111111
        1000000000110000000000001
        1011000001110000000000001
        1001000000000000000000001      111111111111111111111111111111111111111111
111111111011000001110000000000001      100000000000000000000000000000000000000001
100000000011000001110110011111111      100000000000000000000000000000000000000001
1111011111111101110000010001           100000000000000000001000000000000110000001
111101111111110111010100100011111111111100000000000000010000000000000000010000001
110000001101010111000000100010000000000000000000000000000000000000000000110000001
100000000000000011000000100000000000000000000000000000000000000000000000000000001
100000000000000011010100100011111111111100000000000000000000000000000000000000011
11000001110101011111011110W0111        100000000000000000000000000000000000000001
11110111 1110101 101111010001          100000000000000000000000000000000000000001
11111111 1111111 111111111111          111111111111111111111111111111111111111111

