NO images_png/astronaut_1_128x128.png
SO images_png/astronaut_2_128x128.png
WE images_png/astronaut_3_128x128.png
EA images_png/astronaut_4_128x128.png

F 220,155,200
C 225,230,0

        1111111111111111111111111
        1000000000110000000000001
        1011000001110000000000001
        1001000000000000000000001      1111111111111111111111111
111111111011000001110000000000001      1000000000000000000000001
100000000011000001110110011111111      1000000000000000000000001
1111011111111101110000010001           1000000000000000000010001
1111011111111101110101001000111111111111000000000000000100000001
1100000011010101110000001000100000000000000000000000000000000001
1000000000000000110000001000000000000000000000000000000000000001
1000000000000000110101001000111111111111000000000000000000000001
11000001110101011111011110E0111        1000000000000000000011001
11110111 1110101 101111010001          1000000000000000000010001
11111111 1111111 111111111111          1111111111111111111111111

